######_#####
#----###---#
#-$$-----#@#
#-$-#...---#
#---########
#####_______