#######
#-----#
#-.$.-#
#-$.$-#
#-.$.-#
#-$.$-#
#--@--#
#######