__######_
__#----#_
__#-##@##
###-#-$-#
#-..#-$-#
#-------#
#--######
####_____