##################################################
#---#@----#---##--#---##--#---##--#---##--#---#--#
#-#-#-----#-------#-------#-------#-------#------#
#-#--#-##-##-###--##-###--##-###--##-###--##-##--#
#--#-#$#------##-###--##-###--##-###--##-###--#--#
##-#---#---#--#-------#-------#-------#-------#--#
#--#########--#---##--#---##--#---##--#---##--#--#
#-#--#---#--######--######--######--######--###-##
#-#------#-------#-------#-------#-------#-------#
#-#--##-##--###--#--###--#--###--#--###--#--##-#-#
#-##-#--###-##--###-##--###-##--###-##--###-##---#
#--#-#-------#-------#-------#-------#--------####
##-#-#--##---#--##---#--##---#--##---#--###---#--#
#--#-###--######--######--######--######--#####--#
#-#-------#-------#-------#-------#-------#------#
#-#---##--#--###--#--###--#--###--#--###--#--##-##
#--#####-###--##-###--##-###--##-###--##-###--#-##
##-#--#-------#-------#-------#-------#-------#-##
#--#--#---##--#---##--#---##--#---##--#---##--#-##
#-##--#########################################-##
#---#--------------------------------------------#
###-#-########################################---#
#---#-#---##--#---##--#---##--#---##--#---##--####
#-###-#-------#-------#-------#-------#-------#--#
#--##-##-###--##-###--##-###--##-###--##-###--#--#
##-#------##-###--##-###--##-###--##-###--##-##--#
#--#---#--#-------#-------#-------#-------#-----##
#-######--#---##--#---##--#---##--#---##--#---#-##
#-----#########################################-##
#####-#--##---#--##---#--##---#--##---#--##---#-##
#-----#-------#-------#-------#-------#-------#-##
#-#####--###-##--###-##--###-##--###-##--###-##-##
#--#--##-##--###-##--###-##--###-##--###-##--##-##
##-#------#-------#-------#-------#-------#------#
#--#--#---#--##---#--##---#--##---#--##---#--#---#
#-###-############################################
#--##-##--#---##--#---##--#---##--#---##--#---#--#
##-#------#-------#-------#-------#-------#------#
#--#---#--##-###--##-###--##-###--##-###--##-##--#
#--#####-###--##-###--##-###--##-###--##-###--#--#
#-#---#-------#-------#-------#-------#-------#--#
#---#-#---##--#---##--#---##--#---##--#---##--#--#
#####-#########################################--#
#---#-#--##---#--##---#--##---#--##---#--##---#--#
#-----#-------#-------#-------#-------#-------#--#
##-#-.#--###-##--###-##--###-##--###-##--###-##--#
#--#####-##--###-##--###-##--###-##--###-##--##-##
#---------#-------#-------#-------#-------#------#
#--####---#--##---#--##---#--##---#--##---#--#---#
##################################################