#####____
#---##___
#-$--#___
##-$-####
_###@.--#
__#--.#-#
__#-----#
__#######