_#######
_#-----#
_#-.$.-#
##-$@$-#
#--.$.-#
#------#
########