########
#------#
#-.**$@#
#------#
#####--#
____####