______#####
______#.--#
______#.#-#
#######.#-#
#-@-$-$-$-#
#-#-#-#-###
#-------#__
#########__