---######
-###..$-#
-#.$*-*.#
##.-*.$-#
#-$$$*--#
#@$---.-#
#########