######--
#..*.###
#.$$-$-#
###-...#
###$$$-#
#-$-#--#
#-@----#
########