-######-
-#.---#-
##*#.-#-
#--$-$##
#--*.$-#
#-$-@-.#
########