------####
#######..#
#.$....$-#
#-$#$$-$-#
#@$--*.$$#
####.----#
---#######