--########
-##.---..#
##-*-$$$-#
#.-**#@$-#
#---.-$--#
##########