-----#####
--####-..#
###....*##
#--$-#-*-#
#-$$$$$--#
#+$------#
##########