---######
-###..*-#
##---$--#
#-..*-$-#
#-$$$$*.#
#-.$+$.-#
#########