-#######
-#.$.$.#
##*$.--#
#-.-*--#
#..$.$-#
#$$$*$$#
#+-.---#
########