----######
-####-...#
##...*.*##
#-$-$#$--#
#@$$$-$--#
#-$--.--##
#########-