#########
#.--.$.-#
#-*.*---#
#-$$$$$*#
#...--$@#
#########