#########--
#.....*-###
#$-$-$--$-#
#.-.#$$$@-#
#.$.----$-#
###########