#######################
#--.--#-*-*-*------.--#
#-*$$-#-*-$..-#####$#-#
#--#-.#-#-.$-.*-*-*-#-#
#-##$-$-#--$.$*-#-.-#-#
#-#---*.#$.*-.*-#.--#-#
#-#-#-$.$.-**$*-#-$-#-#
#-#-.-*-$.*$.-.-$-$-#-#
#-#****-*$.-*-.**.$$#-#
#-#-----.---#-$.--..#-#
#$#$***$##*$**$#$$#$#$#
#.-.---.---.-*-#-..-$.#
#-$#.$***#*-*$.#-$$.#-#
#-.$$.$.@-*.-$--#$-.$.#
#-$#-.*#$*$#-**.--$-#-#
#.-*.-*-$.-#--#$*.-*--#
#-$*$**-*--##-#-***.$.#
###.$-$--..#.-#.$-.$--#
#-$-#-***#$#-#-$..$-.##
#.-.$.--*-..-..$---#$-#
#-$$$-$-$..*$$$$-###--#
#-.-.-*-.-----#-.---*-#
#######################