################################
#----------------.#---#-$----..#
#-############-$$-#.-*--#-##$.-#
#-#----#------##--$$-#.-$.$-**$#
#-#-#.-$-####---#.-*-##*#.-.---#
#-#---*###---##--#---.#-$-*-*$-#
#-#-*--#--$#---#-####--.#$###.-#
#-##-###$#.--#-#----#$#-----**##
#-#------#-$.$.-#-.$@$-####----#
#-#-*-*$*####*#--#-#-*-.--####$#
#-#-$##--*--*-#-$$*###*##---#-.#
#-##.-#..*$.*-#-...#---#--$-$-.#
#---#-#--*----..$$.#-#---#*.#--#
#-#$#-#*$*#-*-*..--#.$---#--####
#-#-#.#-----*-$*$#$#######*-.--#
#-$---#**.*-*-*.-.-#--$---.-*$*#
###-#.#-.-#**-$--###-##-#**$$--#
#---#-#-$-$---.#*#-$.---*-.$.*.#
#-*.$--##-#-*-*$-#-#-#-#-$.-**.#
#$*#-$-.#-*-*.---#-#$#-#--*$$-*#
#--##########-#**$.-.--##-*-.*-#
#.---*-*-*-#--#-.*$####-$.$$*.-#
#--*---#-#-#-$#$.$-.----.-.-#--#
#*#*-*-$-$-#--#-.***.#-######$##
#----**#-.-#*$#.$$---$-#---*-*-#
#***---*.**#--#--#######*#-#---#
#--*-*-----##---#-----$.-.-#-#-#
#-**-**#*#*$..#--$###-..*-$--$-#
#--#-------#*####.--##-##.-#-$-#
#*-*-*-*-#-$-..$--*-*-$-#$-#$$-#
#----*-*-*-#-$---.*---.-*.-#---#
################################