-----#####-----
----##---##----
---##--*--##---
--##--*-*--##--
-##--*-*-*--##-
##--*-*-*-*--##
#--*-*-*-*-*--#
#-***.*-***-*-#
#-*-*-***-*-*-#
#-*-$-----*-*-#
#-*-*******-*-#
#-*----@----*-#
#-###########-#
#-------------#
###############