######################
#.-.*.$-*-$.*.$----$-#
#-*.......------$--$-#
#$.############--$$$-#
#..--*---$-*-*-#$--$-#
##.$-*--$-.--*.#--$$-#
##.*#-*---###-$-#--$-#
#-*.#-#$##..--*-.##@-#
#-.#.*-$-.#$$-#-#-.*-#
#-.#-----$----$--*.#*#
##*$-####--.##$$$---*#
#--##..$-*#**.----$--#
#----$-$----*#$$$$$$.#
#-*.*-..*-*.--------.#
######################