#######################################################################################
#-.-*--*-.-*-*-*-*-*--*-$-*-*-*-$-*--*-*-*-*-*---*--*-$-*-*-*-*-*--*-.-*-*-*-.-*--*-$-#
#$#-#-##-#$--#---#-#-##-#.--#--.#-#-##-#---#--.#-#-##-#.--#---#-#-##-#$--#--$#-#-##-#.#
#----------#####----------#####----------#####----------#####----------#####----------#
#*#-####-#*#----.#-####-#*#----.#-####-#*#----.#-####-#*#----.#-####-#*#----.#-####-#*#
#-#-#--#---##-##$#-#--#---##-##$#-#--#---##-##$#-#--#---##-##$#-#--#---##-##$#-#--#---#
#---#--#-#--*--#---#--#-#--*--#---#--#-#--*--#---#--#-#--*--#---#--#-#--*--#---#--#-#-#
#*#-####-#*#---#*#-####-#*#---#*#-####-#*#---#*#-####-#*#---#*#-####-#*#---#*#-####-#*#
#----------#####----------#####----------#####----------#####----------#####----------#
#.#-##-#-#.--#---#-##-#-#$--#---#-##-#-#$--#--.#-##-#-#---#--$#-##-#-#---#--$#-##-#-#.#
#-$-.$-*-$-*-*-*-*-*--*-.-*-*-*-*-*--*-.-*-*-*-$-*--*-*-*-*-*-.-*--*-*-*-*-*-.-*--*-$-#
#*-#-####-*#####*-######-*#####*-######-*#####*-######-*#####*-######-*#####*-##-###-*#
#--#-#--#--#---#--#----#--#---#--#----#--#---#--#----#--#---#--#----#--#---#--#-*#-#--#
#*##----##*#-#-#*##-##-##*#-#-#*##-##-##*#-#-#*##-##-##*#-#-#*##-##-##*#-#-#*##----##*#
#--#-#*-#--#---#--#----#--#---#--#----#--#---#--#----#--#---#--#----#--#---#--#--#-#--#
#*-###-##-*#####*-######-*#####*-######-*#####*-######-*#####*-######-*#####*-####-#-*#
#-$-*--*---*-*-*---*--*---*-*-*-.-*--*-*-*-*-*-$-*--*-.-*-*-*---*--*-*-*-*-*---*-$.---#
#.#-#-##-#*--#--*#-#-##-#*--#--$#-#-##-#---#--.#-#-##-#$--#--*#-#-##-#---#--*#-#-##-#*#
#----------#####----------#####----------#####----------#####----------#####----------#
#*#-####-#*#---#*#-####-#*#---#*#-####-#*#---#*#-####-#*#---#*#-####-#*#---#*#-####-#*#
#-#-#--#---#-#-#-#-#--#---#--*--#-#--#---#--*--#-#--#---#--*--#-#--#---#--*--#-#--#---#
#---#--#-#-#-#-#---#--#-#$##-##---#--#-#$##-##---#--#-#$##-##---#--#-#$##-##---#--#-#-#
#*#-####-#*#---#*#-####-#.----#*#-####-#.----#*#-####-#.----#*#-####-#.----#*#-####-#*#
#----------#####----------#####----------#####----------#####----------#####----------#
#.#-##-#-#*--#---#-##-#-#*--#--$#-##-#-#$--#--$#-##-#-#.--#---#-##-#-#---#--.#-##-#-#$#
#-$-.$-*---*-*-*-*-*--*---*-*-*---*--*-.-*-*-*-.-*--*-$-*-*-*-*-*--*-*-*-*-*-$-*--*-.-#
#*-#-####-*#####*-##-###-*#####*-######-*#####*-######-*#####*-######-*#####*-######-*#
#--#-#--#--#---#--#-*#-#--#---#--#----#--#---#--#----#--#---#--#----#--#---#--#----#--#
#*##----##*#-#-#*##----##*#-#-#*##-##-##*#-#-#*##-##-##*#-#-#*##-##-##*#-#-#*##-##-##*#
#--#-#*-#--#---#--#--#-#--#---#--#----#--#---#--#----#--#---#--#----#--#---#--#----#--#
#*-###-##-*#####*-####-#-*#####*-######-*#####*-######-*#####*-######-*#####*-######-*#
#-.-*--*-$-*-*-*---*-$.-.-*-*-*-*-*--*-$-*-*-*-.-*--*---*-*-*-$-*--*-$-*-*-*---*--*-.-#
#$#-#-##-#.--#--*#-#-##-#$--#---#-#-##-#.--#--$#-#-##-#*--#--.#-#-##-#.--#--*#-#-##-#$#
#----------#####----------#####----------#####----------#####----------#####----------#
#*#-####-#*#---#*#-####-#*#----.#-####-#*#----.#-####-#*#----.#-####-#*#----.#-####-#*#
#-#-#--#---#-#-#-#-#--#---##-##$#-#--#---##-##$#-#--#---##-##$#-#--#---##-##$#-#--#---#
#---#--#-#-#-#-#---#--#-#--*--#---#--#-#--*--#---#--#-#--*--#---#--#-#--*--#---#--#-#-#
#*#-####-#*#---#*#-####-#*#---#*#-####-#*#---#*#-####-#*#---#*#-####-#*#---#*#-####-#*#
#----------#####----------#####----------#####----------#####----------#####----------#
#$#-##-#-#$--#---#-##-#-#*--#--.#-##-#-#.--#--$#-##-#-#$--#--.#-##-#-#*--#--.#-##-#-#*#
#-.-.$-*-.-*-*-*-*-*--*---*-*-*-$-*--*-$-*-*-*-.-*--*-.-*-*-*-$-*--*---*-*-*-$-*--*---#
#*-#-####-*#####*-######-*#####*-######-*#####*-######-*#####*-######-*#####*-##-###-*#
#--#-#--#--#---#--#----#--#---#--#----#--#---#--#----#--#---#--#----#--#---#--#-*#-#--#
#*##----##*#-#-#*##-##-##*#-#-#*##-##-##*#-#-#*##-##-##*#-#-#*##-##-##*#-#-#*##----##*#
#--#-#*-#--#---#--#----#--#---#--#----#--#---#--#----#--#---#--#----#--#---#--#--#-#--#
#*-###-##-*#####*-######-*#####*-######-*#####*-######-*#####*-######-*#####*-####-#-*#
#---*--*-$-*-*-*---*--*-$-*-*-*-.-*--*-.-*-*-*-$-*--*-$-*-*-*---*--*-*-*-*-*-.-*-$.-.-#
#*#-#-##-#.--#--*#-#-##-#.--#--$#-#-##-#$--#--.#-#-##-#.--#--*#-#-##-#---#--$#-#-##-#$#
#----------#####----------#####----------#####----------#####----------#####----------#
#*#-####-#*#---#*#-####-#*#---#*#-####-#*#---#*#-####-#*#---#*#-####-#*#---#*#-####-#*#
#-#-#--#---#-#-#-#-#--#---#--*--#-#--#---#--*--#-#--#---#--*--#-#--#---#--*--#-#--#-#-#
#---#--#-#-#-#-#---#--#-#$##-##---#--#-#$##-##---#--#-#$##-##---#--#-#$##-##---#--#---#
#*#-####-#*#---#*#-####-#.----#*#-####-#.----#*#-####-#.----#*#-####-#.----#*#-####-#*#
#----------#####----------#####----------#####----------#####----------#####----------#
#$#-##-#-#*--#--.#-##-#-#.--#--*#-##-#-#$--#--.#-##-#-#---#--$#-##-#-#*--#--.#-##-#-#$#
#-.-.$-*---*-*-*-$-*--*-$-*-*-*---*--*-.-*-*-*-$-*--*-*-*-*-*-.-*--*---*-*-*-$-*--*-.-#
#*-#-####-*#####*-##-###-*#####*-######-*#####*-######-*#####*-######-*#####*-######-*#
#--#-#--#--#---#--#-*#-#--#---#--#----#--#---#--#----#--#---#--#----#--#---#--#----#--#
#*##----##*#-#-#*##----##*#-#-#*##-##-##*#-#-#*##-##-##*#-#-#*##-##-##*#-#-#*##-##-##*#
#--#-#*-#--#---#--#--#-#--#---#--#----#--#---#--#----#--#---#--#----#--#---#--#----#--#
#*-###-##-*#####*-####-#-*#####*-######-*#####*-######-*#####*-######-*#####*-######-*#
#-.-*--*-$-*-*-*-*-*-$.-*-*-*-*-$-*--*-*-*-*-*-.-*--*-.-*-*-*---*--*-*-*-*-*---*--*-$-#
#$#-#-##-#.--#---#-#-##-#---#--.#-#-##-#---#--$#-#-##-#$--#--*#-#-##-#---#--*#-#-##-#.#
#----------#####----------#####----------#####----------#####----------#####----------#
#*#-####-#*#---#*#-####-#*#----.#-####-#*#----.#-####-#*#----.#-####-#*#----.#-####-#*#
#-#-#--#---#-#-#-#-#--#---##-##$#-#--#---##-##$#-#--#---##-##$#-#--#---##-##$#-#--#---#
#---#--#-#-#-#-#---#--#-#--*--#---#--#-#--*--#---#--#-#--*--#---#--#-#--*--#---#--#-#-#
#*#-####-#*#---#*#-####-#*#---#*#-####-#*#---#*#-####-#*#---#*#-####-#*#---#*#-####-#*#
#----------#####----------#####----------#####----------#####----------#####----------#
#*#-##-#-#*--#---#-##-#-#*--#---#-##-#-#*--#---#-##-#-#$--#--*#-##-#-#*--#--*#-##-#-#.#
#---.$-*---*-*-*-*-*--*---*-*-*-*-*--*---*-*-*-*-*--*-.-*-*-*---*--*---*-*-*---*--*-$-#
#*-#-####-*#####*-######-*#####*-######-*#####*-######-*#####*-######-*#####*-##-###-*#
#--#-#--#--#---#--#----#--#---#--#----#--#---#--#----#--#---#--#----#--#---#--#-*#-#--#
#*##----##*#-#-#*##-##-##*#-#-#*##-##-##*#-#-#*##-##-##*#-#-#*##-##-##*#-#-#*##----##*#
#--#-#*-#--#---#--#----#--#---#--#----#--#---#--#----#--#---#--#----#--#---#--#--#-#--#
#*-###-##-*#####*-######-*#####*-######-*#####*-######-*#####*-######-*#####*-####-#-*#
#-$-*--*-.-*-*-*-*-*--*-*-*-*-*-.-*--*-$-*-*-*-.-*--*-*-*-*-*-.-*--*-*-*-*-*-$-*-$.-$-#
#.#-#-##-#$--#---#-#-##-#---#--$#-#-##-#.--#--$#-#-##-#---#--$#-#-##-#---#--.#-#-##-#.#
#----------#####----------#####----------#####----------#####----------#####----------#
#*#-####-#*#---#*#-####-#*#---#*#-####-#*#---#*#-####-#*#---#*#-####-#*#---#*#-####-#*#
#-#-#--#---#--*--#-#--#---#--*--#-#--#---#--*--#-#--#---#--*--#-#--#---#-----#-#--#---#
#---#--#-#$##-##---#--#-#$##-##---#--#-#$##-##---#--#-#$##-##---#--#-#$##*##---#--#-#-#
#*#-####-#.----#*#-####-#.----#*#-####-#.----#*#-####-#.----#*#-####-#.--@-#*#-####-#*#
#----------#####----------#####----------#####----------#####----------#####----------#
#.#-##-#-#$--#--$#-##-#-#$--#--.#-##-#-#.--#---#-##-#-#.--#--.#-##-#-#---#--$#-##-#-#$#
#-$-*--*-.-*-*-*-.-*--*-.-*-*-*-$-*--*-$-*-*-*-*-*--*-$-*-*-*-$-*--*-*-*-*-*-.-*--*-.-#
#######################################################################################