####################
#--*------###------#
#-*#-###----#$$$$$-#
#--*-*--#*#--$---$-#
##---*--#-#--#---$-#
##--#*--#---..#$$$-#
##-#-**-####.-#--$-#
##*#-----#....--#$-#
##---*-**#....#--$-#
###-####-##....-#$-#
#-*-*--*---######@-#
#----*-#---------*-#
#--#-*-#-*####-*-###
#-#-**-##-----#*--##
#*#----#--*-*-#-*-##
#--*--##**-#*--#--##
#--###-----#--*#**-#
#*-*--*-#*--#------#
#---#---#---*-#--*-#
####################